5
5 2
1 0 
1 0 
1 0 
1 0 
1 1
16 6
1 1 1 1 1 1 
1 1 1 1 0 1 
0 1 1 0 1 0 
0 1 1 1 1 0 
1 1 0 1 1 1 
0 1 0 1 1 1 
1 1 1 1 1 1 
1 1 0 1 1 1 
0 0 0 1 0 0 
0 0 0 1 1 1 
1 1 1 0 1 1 
0 0 0 1 1 1 
1 1 1 1 1 1 
1 1 0 1 1 0 
1 1 1 1 1 1 
1 1 1 1 1 1 
15 16
1 1 1 0 1 1 0 1 0 1 0 0 0 1 1 1 
0 1 1 1 0 1 1 1 1 1 1 0 1 1 1 1 
1 1 0 1 1 1 1 1 1 1 1 1 1 1 0 1 
1 0 1 1 1 1 0 1 1 0 1 1 1 1 0 0 
1 0 0 0 1 1 1 1 1 1 1 1 1 0 1 0 
1 0 1 1 1 0 1 0 1 0 1 0 0 1 1 1 
1 0 1 1 1 1 1 0 0 1 0 0 1 0 0 0 
1 1 1 1 1 0 0 0 1 1 1 1 1 1 1 1 
0 1 0 1 1 0 1 1 0 0 1 1 1 1 1 1 
1 1 0 1 1 1 0 1 1 1 0 1 0 0 0 1 
1 1 0 0 1 1 0 1 1 0 1 1 1 1 0 1 
1 0 1 1 1 0 0 1 0 1 1 1 0 1 1 1 
1 0 0 0 0 1 1 1 1 1 1 0 1 1 1 1 
1 0 1 1 1 1 1 1 1 1 1 1 0 1 1 1 
1 0 1 1 1 0 1 0 0 1 1 0 1 1 1 1
27 21
1 1 1 1 0 0 1 0 0 1 1 1 1 1 1 1 1 1 1 0 1 
1 1 1 1 1 1 1 1 1 1 1 1 1 1 0 1 1 0 1 1 1 
0 1 0 1 1 1 1 1 1 0 1 0 0 1 1 1 0 1 0 1 1 
1 0 1 0 1 1 0 0 1 1 1 0 1 0 1 1 1 1 1 0 1 
0 0 0 1 0 1 1 0 1 1 1 1 1 1 1 1 0 1 1 0 1 
1 1 1 1 0 0 1 1 1 1 1 1 0 0 1 0 1 0 1 0 0 
1 1 1 0 1 1 0 1 1 0 1 1 1 1 1 0 1 0 1 1 0 
1 1 0 1 1 1 0 0 0 1 1 1 0 1 0 0 1 1 1 0 0 
0 1 0 1 0 1 1 1 1 1 1 1 1 1 0 1 0 1 1 1 1 
1 1 1 1 0 1 1 1 0 1 1 1 1 1 0 0 0 0 1 1 1 
0 1 1 1 1 0 1 1 1 0 1 1 0 1 0 0 1 1 1 1 1 
1 0 1 1 1 1 1 0 1 0 1 0 1 0 1 1 0 1 1 0 0 
0 0 1 1 1 1 1 0 1 0 1 1 1 1 1 0 1 0 0 0 0 
1 0 0 0 1 1 1 1 0 0 1 1 1 1 0 1 1 1 1 0 1 
1 1 1 0 1 0 0 1 0 1 0 1 0 1 1 0 1 1 0 1 1 
0 0 1 1 0 1 1 1 0 1 1 1 1 0 0 1 1 1 1 0 1 
1 0 0 1 0 1 1 1 1 1 1 1 1 1 1 1 1 1 1 1 1 
1 1 1 1 0 1 0 1 0 1 0 1 1 1 0 1 0 1 0 1 0 
0 1 1 0 1 1 1 0 1 1 0 0 1 0 1 1 0 1 1 1 1 
0 1 0 1 0 0 0 0 1 0 0 0 1 0 0 0 1 1 0 1 1 
0 1 0 0 0 1 0 1 1 0 1 1 1 1 1 1 0 1 1 1 1 
1 0 1 1 0 0 1 0 1 1 1 0 1 0 1 1 1 1 1 0 1 
0 1 1 1 1 0 1 1 1 1 1 1 0 1 1 0 1 0 1 1 0 
1 1 1 1 1 1 0 1 0 1 1 1 0 0 1 1 1 1 1 0 1 
1 1 0 0 1 0 0 1 0 1 0 0 0 1 1 0 1 1 1 0 1 
1 1 1 1 0 1 1 0 1 1 1 1 1 1 1 1 1 1 0 1 1 
1 0 1 1 1 1 0 0 1 0 0 1 0 1 1 1 0 1 1 1 1
36 26
1 0 1 1 1 0 0 0 1 1 1 0 1 0 1 0 1 0 1 0 1 0 1 1 0 1 
1 1 1 1 0 0 1 1 0 1 0 0 1 1 0 0 0 1 0 0 1 1 0 0 1 0 
1 1 0 1 0 1 0 0 1 1 0 1 1 1 0 1 1 1 0 1 1 1 0 0 1 1 
1 1 1 1 0 1 1 1 1 0 0 1 1 1 1 1 1 0 0 1 1 1 1 0 1 0 
1 1 0 0 1 0 0 1 1 1 1 1 1 1 0 1 1 1 0 1 0 1 1 0 0 1 
1 1 1 1 0 0 1 0 1 1 1 1 0 1 0 0 0 1 1 1 0 1 0 1 0 1 
1 1 0 1 1 1 1 0 1 0 1 1 1 1 0 0 1 1 0 1 1 0 1 0 0 0 
1 0 1 1 0 0 0 1 0 1 0 1 1 1 1 0 1 0 1 1 0 0 1 0 0 1 
1 0 1 1 1 1 1 0 0 1 1 1 1 0 1 1 1 0 1 1 0 0 1 0 1 0 
1 1 1 1 0 0 0 0 0 0 1 1 1 1 1 1 1 1 0 1 1 1 1 1 1 1 
1 0 1 1 1 1 0 1 0 1 1 1 1 1 1 0 0 0 1 1 0 0 0 1 0 1 
1 1 0 1 1 1 0 1 0 1 1 0 1 0 0 1 0 1 1 1 1 1 0 0 1 1 
0 0 1 1 0 0 1 0 1 1 1 0 1 1 1 1 1 0 0 1 1 0 0 0 0 1 
0 1 0 1 1 1 1 1 1 0 1 1 1 0 1 1 1 1 0 0 0 1 1 1 0 1 
0 0 1 0 1 1 0 1 0 1 1 1 1 1 1 1 0 0 1 1 1 0 1 0 0 1 
1 1 1 1 1 0 1 1 0 1 1 1 1 0 1 1 0 1 0 1 1 0 1 1 1 1 
1 1 0 0 0 1 1 1 0 0 1 0 1 1 1 1 1 0 1 1 1 1 1 1 0 1 
1 1 1 1 1 1 1 1 1 1 1 1 1 1 1 1 0 1 1 1 1 0 1 1 1 1 
1 0 0 1 0 1 1 1 1 0 1 1 0 1 1 1 0 1 1 1 0 0 0 1 1 1 
1 0 1 0 1 1 1 1 1 1 1 1 0 1 1 0 0 0 1 1 1 1 1 0 1 0 
0 1 1 0 1 1 1 1 1 1 1 1 1 1 1 1 0 1 1 0 0 1 1 1 1 1 
0 1 0 1 1 1 1 1 0 1 1 1 1 1 1 0 1 1 1 0 1 0 0 0 1 1 
0 1 0 1 0 1 1 0 0 1 1 0 0 1 1 0 1 1 0 1 0 1 0 0 1 1 
1 1 1 1 0 1 1 1 1 1 0 1 1 1 1 0 1 1 0 0 1 0 1 0 1 1 
1 1 1 1 0 1 0 0 0 1 1 1 0 1 0 0 1 1 1 1 1 1 1 1 1 0 
0 0 0 1 1 0 1 0 0 0 1 1 0 1 1 1 0 1 0 1 0 1 1 1 1 1 
1 0 1 0 0 1 0 1 0 0 1 1 1 0 1 1 1 0 0 0 0 0 1 1 1 1 
1 1 0 1 1 0 1 1 1 1 1 0 1 1 1 0 1 1 0 1 1 1 1 1 1 1 
0 1 1 0 1 0 0 1 1 0 0 0 1 0 0 0 1 1 1 1 1 1 1 1 1 1 
0 0 1 1 0 0 1 0 0 1 1 1 0 1 1 1 1 0 1 0 1 0 1 0 1 1 
1 1 1 1 1 0 1 0 1 1 1 0 0 0 1 1 1 1 1 1 1 1 1 0 1 1 
0 1 1 1 1 1 1 0 1 1 0 0 0 1 1 0 1 1 0 0 1 0 0 1 1 1 
0 0 1 0 1 0 1 1 1 0 1 1 1 1 0 1 1 1 1 1 1 1 0 1 1 0 
1 1 1 0 1 0 1 1 0 0 1 1 0 1 1 0 1 1 1 1 0 1 0 0 1 1 
1 0 1 0 1 1 1 1 1 1 1 0 1 1 1 1 0 1 1 0 1 1 0 0 0 1 
0 1 0 0 1 1 1 1 1 1 1 0 1 1 0 0 1 1 0 1 1 1 1 0 0 1 